11111111111
100100000C1
10000111101
1P0011E0001
11111111